1111111
1PC0CE1
1000001
1111111