1111111111111111111
10000C00C00000C111
1001011111000001111
10010000C0000P01111
10010C00000000E1111
10001111101100C00C1
1111111111111111111